NO ./path_to_the_north_texture
SO ./path_to_the_south_texture
WE ./path_to_the_west_texture
EA ./path_to_the_east_texture
F 220,100,0
C 225,30,0
111111111111111111111
101000001000000000001
101010101011111110001
100010100010000010001
111110000000000011101
100000000000000000001
101110000000000111111
101000000000000000101
101010000000000110101
101010000S00000010101
101110000000000010101
100000000000000010001
111110000000000011101
100000000000000010001
101110000000000110111
101000100000100010101
101011111111111010101
100010000000000010001
101010111011111111101
101000001000000000001
111111111111111111111