NO ./textures/a.png
SO ./textures/s.png
WE ./textures/w.png
EA ./textures/e.png
F 220,100,0
C 225,30,0
111111111111111111111
101000001000000000001
101010101011111110001
100010100010000010001
111110101111101011101
100000101000101000001
101111101011101111111
101000001010100000101
101011111010111110101
101010001010100010101
101110101010101010101
100000101010001010001
111111101011111011101
100000101000100010001
101110101110101110111
101000100000100010101
101011111111111010101
100010000000000010001
101010111011111111101
1N1000001000000000001
111111111111111111111

1111111
1000001
100N001
1000001
1111111

tae

11111111
10010001
10W01001
10001001
10000011
11111111
11111111
11111111



map: doesn't contain


111111111111111111111
101000001000000000001
101010101011111110001
100010100010000010001
111110101111101011101
100000101000101000001
101111101011101111111
101000001010100000101
101011111010111110101
101010001010100010101
101110101010101010101
100000101010001010001
111111101011111011101
100000101000100010001
101110101110101110111
101000100000100010101
101011111111111010101
100010000000000010001
101010111011111111101
1N1000001000000000001
111111111111111111111



1111111111111111
         1111111111111111111111111
        1000000000110000000000001
        1011000001110000000000001
        1001000000000000000000001
111111111011000001110000000000001
100000000011000001110111111111111
11110111111111011100000010001
11110111111111011101010010001
11000000110101011100000010001
10000000000000001100000010001
10000000000000001101010010001
11000001110101011111011110N0111
11110111 1110101 101111010001
11111111 1111111 111111111111
111111111111111



1111111111111111111111111111111111
1111111110000000001100000000000011
1111111110110000011100000000000011
1111111110010N00000000000000000011
1111111110110000011100000000000011
1000000000110000011101111111111111
1111011111111101110000001000111111
1111011111111101110101001000111111
1100000011010101110000001000111111
1000000000000000110000001000111111
1000000000000000110101001000111111
1100000111010101111101111000111111
1111011111110101110111101000111111
1111111111111111111111111111111111
1111111111111111111111111111111111



    1111111111111111111111111         
   10000000000000000000001      
  1000000000000001000000001      
 1000000000000000000000001
1000000000000000000000001
 1000000000001000000000001
  1000000000000000000000001
   1000000000000000000000001
  1000000000000000000000001
 100000000000N000000000001
1111111111111111111111111



11111111111111111111111111111111111 11111  1111111
1111E000000000000000000000000000001 10001  1000011
11110000000000000000000000000000001 10001  1000011
11111000000000000000000000000000001110001  1000011
    1000000000000000000000000000000000001  10000111111
    1000000000000000000000000000000000001  10000000011
    1000000000110111000111111110000000001  10000000011
    1000000001010101000100000010000000001  10000111111
11111000000010011101000111100010000000001111000011
10000000000100000001000000100100000000000000000011
10000000001111111101000001001000000000000000000011
10000000000000000101000010010000000000000000000011
10000000000000000101000100111110000000000000000011
10000000000000000101000100000000000000000000000011
10000000000000000101000111111110000000000000000011
10000000000000000000000000000000000000000000000011
10000000000000000000000000000000000000000000000011
10000000000000000000000000000000000000000000000011
10000000000000000000000000000000000000000000000011
10000000000000000000000000000000000000000000000011
10000000000000000000000000000000000000000000000011
10000000000000000000000000000000000000000000000011
10000000000000000000000000000000000000000000000011
10000000000000000000000000000000000000000000000011
10000000000000000011111111110111111111111111111111
1111111000000000001001     10000100000000000000011111111
      1000000000001001     10000100000000000000000000001
      10000000000010011111110000100000000000000000000001
11111110000000000010000000000000100000000000000011111001
10000000000000000011111111110000100000000000000011111001
10000000000000000010000000000000100000000000000011111001
10000000000000000010000000000000100000000000000011111001
10000000000000000010000000000000100000000000000011111001
10000000000000000010000000000000100000000000000011111001
11111111111100000110111111111111100000000000000011111001
11111111111000000110000000000000000000000000000011110001
11111111110000000110000000000000000000000000000011110001
11110000000000000110000000000000000000000000000011100001
10000111111000000110000000000000000000000000000011000001
10011111111111111111111111111111111111111111111110000001
10000000000000000000000000000000000000000000000000000001
10000000000000000000000000000000000000000000000000000001
11111111111111111111111111111111111111111111111111111111




1111111111111111111111111111111111111111111
1111110011111111111111111111000S00001111111
1111100001111111111111111110000000001111111
1111100001111111111111111100000000011111111
1110000001111111111111111000000000011111111
1110000001111111111111111000000000001111111
1111000001111111111111111100111110001111111
1111100000111001100111111111111110001111111
1111111110000000000001111111111000001111111
1111111111000000000001111111100000000111111
1111111111110000000000000111000000000111111
1111111111111111111000000000000000001111111
1111111111111111111100000000000000111111111
1111111111111111111100000000000000111111111
1111111111111111111110000000000000111111111
1111111111111111111110000000000000011111111
1111111111111111111110000000000000011111111
1111111111111000000000000000000000111111111
1111111111110000000000000000000111111111111
1111111111110001010000000000011111111111111
1111111111111001110111111110000111000111111
1111111111111111111111111111000000000001111
1111111111111111111111111111110000011111111
1111111111111111111111111111111111111111111
1111111111111111111111111111111111111111111
1111111111111111111111111111111111111111111
1111111111111111111111111111111111111111111
1111111111111111111111111111111111111111111




11111111111111111
	1000000000111
	1000000000111
	1000N00000111
	1110000000001
	1110000000001
	1110000000001
11111111111111111




111111111111111111
1000000N0011100001
100000000011100111
1000000000111001
1110000000010001
1110000000010001
1110000000011001
1010000000001001
1010000000001101
1000000000000001
1111111111111111




11111111111111111111111111111111111111111111111111111111111111111111111111111111
10100000000000000000000000000000000000000000000000000000000000000000000000000001
10001111111111111100111111111111111111001111111111111111101011111111111111111101
11011000100011111110000000001000000001000000001110000000100000000000000000000001
11011010101011000011111111001000110000111111000000011100010000000001111100000111
11010010001000010001000000000000100110100001111111111100111111000111111111111111
1101011111110011110111111111111111111010110001111000000010001101111     11111111
1000000000010000010000000000000000001000011000000011110000100111           11111
10111111111111100111100011111001111111111111111111111111111111               111
10010001000001100111111111111111111111    1111111111111111111   1  1   111    1111111111111111111111111111111111111111111111111111
1001110101110110011111111111111111            11111111111111   1   1  1   1    100000000000000000000000000000000000000000000000011
1000010101110110011111111111111                  11111111111  111111    11      1000000000000000000000000000000000000000000000S011
101001010001011001111111111                          1111111       1   1       100000000000000000000000000000000000000000000000011
101000011101011001111111                                11111     111 11111   1111111111111111111001111111111111111111111111100011
10111111110100100111                   1                    11               11111111111111111111001111100000000000000000000000011
101    1110100100111                 11111                    111         11111111100000000000000001111100000000000000000000000011
101    1110111100111                1110111                      111   11111111111100000000000000001111100000000000000000000000011
101    111011 100111              11110001111                       11111111111111100000000000000001111100000000000000000000000011
10111111110111101111           11111000000011111                      111111111111100011111111111001111100000000000000000000000011
1011111110001100110011           11000000000011                         1111111111100011111111111101111100000000000000000000000011
10000000000110010001111           10000000001                             11111111100011111111111101111100000000000000000000000011
10111111001000100100001            100000001                             111111111101111111111111101111100000000000000000000000011
1011111110010000100001              1100011                             1111111111100111111111111001111100000000000000000000000011
101001100100111000101                 111                              11111111111100000000000000001111100000000000000000000000011
10000110010001111111                   1                              111111111111100000000000000001111100000000000000000000000011
11100110010011                                                       1111000001111100111111111111001111100000000000000000000000011
1010011001001                                                       11111000001111101111111111111101111100000000000000000000000011
10100000011011                                                     111111000001111100011111111100001111100000000000000000000000011
101000001110111                                                   1111111000001111100111111110000001111100000000000000000000000011
1011110010101111    11111111111                                  11111111000001111100001111100011001111100000000000000000000000011
10001100101011111   10000000001                                 111111111000001111101001110000111001111100000000000000000000000011
100000001010111111  10011111111                                1100000011000001111101100100011111001111100000000000000000000000011
10101111101010000111100111                                    10000000011000001111101100000111111001111100000000000000000000000011
1010101000101010001100000111111                              111111100011000001111101111111111111101111100000000000000000000000011
1010101010111010000111100000001111                          1111111100011000001111101111111111111101111100000000000000000000000011
1010001010101011000011111000000001                         11111111000011000001111100000000000000001111100000000000000000000000011
1000011010101011000001111000000001                        110000000000011000001111101111111111111101111100000000000000000000000011
1100110010101011100000111111111111                       1110000000000011000001111101110011111100101111100000000000000000000000011
1001100010101011110000011                               11000001111000011000001111100110011000100101111100000000000000000000000011
10110011111010111110000011                             111000001111000011000001111101011111010111101111100000000000000000000000011
101001100010101000110000011                           1110000011111000011000001111101100000111000001111100000000000000000000000011
1010111010101010001110000011                         11100000011000000111000001111101111111111111101111100000000000000000000000011
10101010101010100000110000011                       111000000011000011111000001111101111111111111101111100000000000000000000000011
101010101010101000000110000011                     1111000000011001110000000001111101000000000000001111100000000000000000000000011
1010101010101010110001110000011                   11111000000011100111000000001111100111111111111101111100000000000000000000000011
1010101010101010110001111000001111111111111111111111111111110001100011100000001111100111100000111101111100000000000000000000000011
1010101010101010110000111100000110000000000000000000000000011100000000111000001111100111111111111101111100000000000000000000000011
1010101010101010110000001110000011000000000000000000000000000111000000011110001111101000000000000001111100000000000000000000000011
1010101010101010110000000111000001100000100000000000000000000001110000000110001111101111111111111101111100000000000000000000000011
1010101010101010110000100011100000110000000001111111111000000000011100000110001111100000000000111101111100000000000000000000000011
1010101010101010110000110001110000011000000011111111111000000000001110000110001111100011001110000101111100000000000000000000000011
1010101010101010110110111000111000001100000111111111111000000000011100000110001111101111101101110001111100000000000000000000000011
1010101010101010110000111100011100000110001111111111111000000000111000001100001111101111101100111101111100000000000000000000000011
1010101010101010110000111110001110000011011111111111111000000001110000011000001111101111101101110001111100000000000000000000000011
1010101010101010111001111111000011000011011111111000001100000011100000110000001111100011001110000111111100000000000000000000000011
1010101010101010110000111111001001110000000001111000011000000111000001100000001111100000000000111111111100000000000000000000000011
1010101010101010110000111110011001111000000011111000011000001110000011000000001111111111111111111111111100000000000000000000000011
1010101010101010110000111100111100111100000111111000011000011100000110000000001111111111111111111111111100000000000000000000000011
1010101010101010110000111001101110011110001111111000011000000000001100000000001100000000000000000000000000000000000000000000000011
1010101010100010110000110011001111001111011111111000011100000000011000000000001100000000000000000000000001110000000000000000000011
1010101010101010110001100110011001100111011111111000111110000000110000000000001100000000000000000000000000111100000000000000000011
1000101010101010110001001100111001110011011111111000111111000111100000000000001100000000000000000000000000001110000000000000000011
1001101010001110110011001001111001111001110000000000111111111100000000000000001100000000000000000000000000000000000000000000000011
1000000011100000110000000000000000001000000000000000000000000000000000000000000000000000000000000000000000000000000000000000000011
1111111111111111111111111111111111111111111111111111111111111111111111111111111111111111111111111111111111111111111111111111111111




1111111111111111111111111111111111111
1000000000000000000000000000000000001
1001000000000000000000000000000001001
1001000000000000000000011100100001001
1001000111000000000000010000100001001
1001000000000000000000010011100001001
1001000000000000000000010000100001001
1001000000111000000000011100100001001
1001000000000000000000010000100001001
1001000000000011100000010011100001001
1001000000000000000000010000100001001
1001000000000000000000011100100001001
1001000000000000000000010000100001001
1001000000000000000000010011100001001
1001000000000000000000010000000001001
1001000000000000000000011111111111001
1000000000000000011110000000000000001
1001000000000000011110000000000001001
1000000000000000011110000000000000001
1001000000000000011110000000000001001
1001000000000000000000000000000001001
1001000000000000000000000000000001001
1001000000000000000000000000000001001
1001000000000000000000000000000001001
1001000000000000000000000000000001001
1001000000000000000000000000000001001
1001000000000000000000000000000001001
1001000000000000000000000000000001001
1001000000000000000000000000000001001
1001000000000000000000000000000001001
1001000000000000000000000000000001001
1001000000000000000000000000000001001
1001000111100000000000001111010001001
1001000111100000000000001000010001001
1001000111100000000000001000010001001
1001000000000000000000001011110001001
1N01000000000000000000000000000000001
1111111111111111111111111111111111111






        1111111111111111111111111
        1000000000110000000000001
        1011000001110000000000001
        1001000000000000000000001
111111111011000001110000000000001
100000000011000001110111111111111
11110111111111011100000000001
11110111111111011101010010001
11000000110101011100000010001
10000000000000001100000010001
10000000000000001101010010001
11000001110101011111011110N0111
11110111 1110101 101111010001
11111111 1111111 111111111111


1111
1001
10W1
1111


1111111111111111111111111111111111111
1000000000000000000000000000000000001
1001000000000000000000000000000001001
1001000000000000000000011100100001001
1001000111000000000000010000100001001
1001000000000000000000010011100001001
1001000000000000000000010000100001001
1001000000111000000000011100100001001
1001000000000000000000010000100001001
1001000000000011100000010011100001001
1001000000000000000000010000100001001
1001000000000000000000011100100001001
1001000000000000000000010000100001001
1001000000000000000000010011100001001
1001000000000000000000010000000001001
1001000000000000000000011111111111001
1000000000000000011110000000000000001
1001000000000000011110000000000001001
1000000000000000011110000000000000001
1001000000000000011110000000000001001
1001000000000000000000000000000001001
1001000000000000000000000000000001001
1001000000000000000000000000000001001
1001000000000000000000000000000001001
1001000000000000000000000000000001001
1001000000000000000000000000000001001
1001000000000000000000000000000001001
1001000000000000000000000000000001001
1001000000000000000000000000000001001
1001000000000000000000000000000001001
1001000000000000000000000000000001001
1001000000000000000000000000000001001
1001000111100000000000001111010001001
1001000111100000000000001000010001001
1001000111100000000000001000010001001
1001000000000000000000001011110001001
1N01000000000000000000000000000000001
1111111111111111111111111111111111111 



1111111111111111111111111111111111111111111
1000000000000000000000000000000001000001001
10000000000000000000000000000000000010000W1
1000111111111111111111111111111111111111111
1000100000000001000000000111111111110000111
1000100000000001000000000111111111110000111
1000100000000001000000000000001111110000111
1000100000000001000000000000000001110000111
1000100000000001000000000000000000000000111
1000100000000000000000000000000000000000111
1000111111111111111111111111111111110000111
1000111111111111111111111111111111110000111
1000000000000000000000000000000000000000111
1000000000000000000000000000000000000000111
1111111111111111111111111111111111111111111










        111111111111111111111111111
        1000000000110000000000001
        1011000001110000000000001
        1001000000C000000000000W1
111111111011000001110000000000001
100000000011000001110111111111111
11110111111111011100000010001
11110111111111011101010010001
11000000110101011100000010001
10000000000000001100000010001    1
10000000000000001101010010001   101
110000011101010111110111100011   1
11110111 1110101 101111010001
11111111 1111111 111111111111
















11111111111111
10000000001001
10001000001001
10000000001OC1
10000000000001
10000000000N01
11111111111111






        111111111111111111111111111
        1000000000110000000000001
        1011000001110000000000001
        10010000000000000000000W1
111111111011000001110000000000001
100000000011000001110111111111111
11110111111111011100000010001
11110111111111011101010010001
11000000110101011100000010001
10000000000000001100000010001    1
10000000000000001101010010001   101
110000011101010111110111100011   1
11110111 1110101 101111010001
11111111 1111111 111111111111



