NO LOLOLOL
WE LIALIAA
SU LAALALA
EA DADSASD

F -1,0,0
C 0,0,0

















NOO LOLOLOL
WE LIALIAA
SU LAALALA
EA DADSASD

F 0,0,0
C 0,0,0












































NO LOLOLOL
WE LIALIAA
SSU LAALALA
EA DADSASD

F 0,0,0
C 0,0,0






NO LOLOLOL
WE LIALIAA
SU LAALALA
EA DADSASD

FF 0,0,0
CC 0,0,0




NO LOLOLOL
WE LIALIAA
SU LAALALA
EA DADSASD

F 265,0,0
CC 0,0,0














NO LOLOLOL
WE LIALIAA
SU LAALALA
EA DADSASD

F 256,0,0
C 0,0,0









NO LOLOLOL
WE LIALIAA
SU LAALALA
EA DADSASD

F 0,255,255
C 0,0,256












NO LOLOLOL
WE LIALIAA
SU LAALALA
EA DADSASD

F 0,0,0
X 0,0,0






























NO LOLOLOL









NO LOLOLOL
WE LIALIAA
SU LAALALA
EA DADSASD

F 1,2,3








NO LOLOLOL
WE LIALIAA
SU LAALALA
EA DADSASD




C 1,2,3
F 1,2,3








NO LOLOLOL


SU LAALALA
EA DADSASD

C 1,2,3
F 3,3,4










NO LOLOLOL



WE LIALIAA
C 1,23,45



EA DADSASD



















C 112,123,132
NO LOLOLOL
F 124,43,32
WE LIALIAA
SU LAALALA
EA DADSASD

























C 3,0,1
F 0,0,0

















NO LOLOLOL
WE LIALIAA
EA DADSASD

F 1,0,255











        111111111111111111111111111
        1000000000110000000000001
        1011000001110000000000001
        1001000000C000000000000W1
111111111011000001110000000000001
100000000011000001110111111111111
11110111111111011100000010001
11110111111111011101010010001
11000000110101011100000010001
10000000000000001100000010001    1
10000000000000001101010010001   101
110000011101010111110111100011   1
11110111 1110101 101111010001
11111111 1111111 111111111111
















11111111111111
10000000001001
10001000001001
10000000001OC1
10000000000001
10000000000N01
11111111111111






        111111111111111111111111111
        1000000000110000000000001
        1011000001110000000000001
        10010000000000000000000W1
111111111011000001110000000000001
100000000011000001110111111111111
11110111111111011100000010001
11110111111111011101010010001
11000000110101011100000010001
10000000000000001100000010001    1
10000000000000001101010010001   101
110000011101010111110111100011   1
11110111 1110101 101111010001
11111111 1111111 111111111111





