NO ./textures/n.png
SO ./textures/s.png
WE ./textures/w.png
EA ./textures/e.png
F 220,100,0
C 225,30,0
11111111
10010001
10W01001
10001001
10000011
11111111